[base]
abjat=abjad
abrasi=aberasi
abreg=abrek
absorsi=absorpsi
accu=aki
adap=adab
adegio=adagio
adek=adik
adesi=adhesi
aditorium=auditorium
admin=administrator
adpokat=advokat
advent=adven
adzan=azan
afdol=afdal
agamis=agamais
agent=agen
ajeg=ajek
ajektif=adjektif
ajimat=azimat
akherat=akhirat
akhlaq=akhlak
akikah=akekah
aksesoris=aksesori
akte=akta
aktifis=aktivis
aktifitas=aktivitas
aktip=aktif
aktiv=aktif
aktive=aktif
aktuil=aktual
akuntan=akutan
akupuntur=akupunktur
akutansi=akuntansi
al-qur'an=Alquran
al-quran=Alquran
alaram=alarm
alenia=alinea
alfa=alpa
alinia=alinea
aliyah=aliah
alloh=Allah
almari=lemari
almunium=aluminium
alpha=alfa
alpokat=avokad
alpukat=avokad
alternatip=alternatif
alumunium=aluminium
amandemen=amendemen
amben=ambin
ambeyen=ambeien
ambulan=ambulans
ambulance=ambulans
amien=amin
amirulhaj=amirulhaji
amoniak=amonia
amper=ampere
amphibi=amfibi
ampibi=amfibi
analisa=analisis
anestesia=anestesi
anggauta=anggota
angpao=angpau
anoda=anode
ansambel=ensambel
antalogi=antologi
antene=antena
antri=antre
antrian=antrean
anugrah=anugerah
apapun=apa pun
aparatur=aparat
apem=apam
aplus=aplaus
apostrop=apostrof
apotik=apotek
aqil=akil
aquades=akuades
aquarium=akuarium
aquatik=akuatik
arbiter=arbitrer
aritmatika=aritmetika
arkheolog=arkeolog
arkheologi=arkeologi
artifak=artefak
asal-muasal=muasal
aseli=asli
aseptor=akseptor
asesori=aksesori
ashar=asar
asik=asyik
astaghfirullah=astagfirullah
astronot=astronaut
atheis=ateis
atlit=atlet
atmosfir=atmosfer
atmosphere=atmosfer
atret=ateret
audiens=audiensi
auliya=aulia
autobiografi=otobiografi
automatic=otomatis
automatis=otomatis
azas=asas
azasi=asasi
azaz=asas
azhab=azab
azhar=Asar
babtis=baptis
baek=baik
bahwasannya=bahwasanya
bakmie=bakmi
bakpau=bakpao
balance=balans
bale=balai
baligh=balig
balpoin=bolpoin
balsem=balsam
bandrol=banderol
bangker=bungker
bapakda=bapanda
bapaknda=bapanda
baqa=baka
barigade=barikade
barzah=barzakh
baso=bakso
batalyon=batalion
batere=baterai
baterei=baterai
bathil=batil
bathin=batin
batre=baterai
bazaar=bazar
beaya=biaya
bedug=beduk
belangko=blangko
belender=blender
belepot=gelepot
belom=belum
beludru=beledu
bemper=bumper
bengap=bengep
bengkoang=bengkuang
bengkowang=bengkuang
bensol=benzol
bergadang=begadang
bergajul=bargajul
berjanji=barzanj
berlepotan=gelepotan
berpetualang=bertualang
berserta=beserta
berterbangan=beterbangan
berternak=beternak
bh=beha
bhayangkara=bayangkara
bhiku=biksu
bhuana=buana
biarpet=byarpet
bienale=bienial
biennale=bienial
bilyar=biliar
bilyun=biliun
binatu=benatu
binatu=penatu
biosfir=biosfer
birahi=berahi
bis=bus
bisep=biseps
blacu=belacu
blanko=blangko
blantika=belantika
blokir=blokade
bloon=beloon
bolpen=bolpoin
bolpoint=bolpoin
bombon=bobon
bonafid=bonafide
bongkok=bungkuk
boss=bos
boulevard=bulevar
bowling=boling
braile=braille
brandal=berandal
brangkas=brankas
breidel=bredel
brengsek=berengsek
brewok=bewok
bridel=bredel
brigade=barikade
brilyan=brilian
brokad=brokat
bromocorah=bramacorah
bronkitis=bronkhitis
buda=Buddha
budeg=budek
budget=bujet
budha=Buddha
bumiputera=bumiputra
bungalow=bungalo
bur=bor
busyet=buset
cabay=cabai
cabe=cabai
cacad=cacat
cafetaria=kafetaria
cape=capai
capek=capai
cathering=katering
cedal=cadel
celos=celus
cemilan=camilan
cendikia=cendekia
cendikiawan=cendekiawan
cengkeh=cengkih
cengkram=cengkeram
cengkrama=cengkerama
centigram=sentigram
centimeter=sentimeter
central=sentral
ceret=cerek
ceritera=cerita
chlor=klor
cicak=cecak
cidera=cedera
cigaret=sigaret
cinderamata=cenderamata
cingcong=cincong
clash=kles
clien=klien
closet=kloset
club=klab
clurit=celurit
cockpit=kokpit
cocktail=koktail
coklat=cokelat
combro=comro
cru=kru
cumulus=kumulus
da'i=dai
da’i=dai
da’wah=dakwah
dajjal=dajal
daptar=daftar
dealer=diler
debet=debit
debetur=debitur
debitur=debitor
defiasi=deviasi
degresi=digresi
degub=degup
dekoratip=dekoratif
dekrit=dekret
deodorant=deodoran
depo=depot
depolitisir=depolitisasi
deputy=deputi
design=desain
despenser=dispenser
destilasi=distilasi
detektip=detektif
detel=detail
deterjen=detergen
detil=detail
deviden=dividen
dharma=darma
dhohir=lahir
dhoif=daif
dhu'afa=duafa
dhuafa=duafa
dhuha=duha
dhuhur=zhuhur
dhuhur=zuhur
diagnosa=diagnosis
diagnose=diagnosis
diantaranya=di antaranya
dimana=di mana
dimanapun=di mana pun
dioda=diode
dipungkiri=dimungkiri
disain=desain
disainer=desainer
disco=disko
diserse=desersi
disersi=desersi
disini=di sini
diskotik=diskotek
diskripsi=deskripsi
ditambahin=ditambahkan
do'a=doa
dollar=dolar
domain=domein
donatur=donator
dopping=doping
dos=dus
dosin=lusin
dozen=lusin
draft=draf
dramatisir=dramatisasi
dramben=drumben
dumping=damping
duren=durian
dzat=zat
dzikir=zikir
dzuhur=zuhur
efektifitas=efektivitas
efektip=efektif
efektive=efektif
eksebisi=ekshibisi
eksem=eksim
eksibisi=ekshibisi
eksim=eksem
eksport=ekspor
ekstrim=ekstrem
ekstrovert=ekstrover
ekwivalen=ekuivalen
elektroda=elektrode
elip=elips
elit=elite
email=e-mail
empek-empek=pempek
eneg=enek
engine=enjin
ensiklopedia=ensiklopedi
epektif=efektif
epektip=efektif
ephos=epos
episod=episode
equivalen=ekuivalen
erobatik=aerobatik
esen=esens
esense=esens
essai=esai
essay=esai
ethanol=etanol
exim=eksem
export=ekspor
extra=ekstra
extrim=ekstrem
facsimil=faksimili
faham=paham
fak=vak
faksimil=faksimile
faksimil=faksimili
faksimili=faksimile
faksinasi=vaksinasi
fakum=vakum
falid=valid
familiar=familier
famplet=pamflet
faqih=fakih
farmakop=farmakope
fas=vas
faseh=fasih
fasip=pasif
faximil=faksimili
february=Februari
feminim=feminin
ferri=feri
fery=feri
fihak=pihak
fikir=pikir
filosof=filsuf
filsof=filsuf
finish=finis
fitoksoit=fitotoksoid
foklor=folklor
formil=formal
fotosintesa=fotosintesis
fotosintetis=fotosintesis
frasa=frase
frase=frasa
frekwensi=frekuensi
frigit=frigid
fron=front
frustasi=frustrasi
furniture=furnitur
galaktose=galaktosa
galery=galeri
galleri=galeri
gamma=game
gandewo=gandewa
garebeg=garebek
gasal=gazal
geladi=gladi
gelo=gila
gendewa=gandewa
geneaologi=genealogi
geneologi=genealogi
genius=jenius
genteng=genting
gep=gap
gepok=kepok
gerejani=gerejawi
gerobag=gerobak
geyser=geiser
ghaib=gaib
ghoib=gaib
gip=gips
gisi=gizi
gladi=geladi
gladibersih=geladi bersih
glamour=glamor
glondong=gelondong
glosary=glosarium
glukoma=glaukoma
glukose=glukosa
goa=gua
goncang=guncang
gono-gini=gana-gini
grameh=gurami
grebeg=garebek
grebek=gerebek
greget=gereget
grendel=gerendel
gria=griya
grogol=gerogol
gross=gros
gubug=gubuk
gudek=gudeg
gulabit=bitgula
gurameh=gurami
guyub=guyup
hadist=hadis
hakekat=hakikat
hal-ihwal=hal-hal
handaitaulan=handaitulan
handal=andal
hapal=hafal
harafiah=harfiah
hektar=hektare
hembus=embus
hempas=empas
hentak=entak
herbivora=herbivor
hetrogen=heterogen
hidrolis=hidraulis
higiena=higiene
himbau=imbau
himpit=impit
hingar-bingar=ingar-bingar
hingar=ingar
hipermetri=hipermetropia
hipotesa=hipotesis
hipotik=hipotek
hipovitaminose=hipovitaminosis
hirarki=hierarki
hiroglif=hieroglif
hisap=isap
hobby=hobi
holistic=holistis
holistik=holistis
honocoroko=hanacaraka
horden=gorden
hordeng=gorden
horison=horizon
hurup=huruf
husada=usada
hutang=utang
hybrida=hibrida
hygiene=higiene
hymne=himne
i’tibar=iktibar
i’tikaf=iktikaf
ibtidaiyah=ibtidaiah
iddah=idah
idial=ideal
idiil=ideal
idiologi=ideologi
ihlas=ikhlas
ijasah=ijazah
ijin=izin
ijma’=ijmak
ikhwal=ihwal
iklas=ikhlas
illusi=ilusi
imajinasi=imaginasi
imel=e-mail
import=impor
incognito=inkognito
income=inkam
indera=indra
indra=indera
influensa=influenza
influinza=influenza
inpus=infus
instink=insting
insyaf=insaf
intel=intelijen
intelegensi=inteligensi
intelejensi=intelegensi
inteligen=intelijen
inten=intens
intercontinental=interkontinental
interest=interes
intermezo=intermeso
internist=internis
interograsi=interogasi
interospeksi=introspeksi
interplasi=interpelasi
interprestasi=interpretasi
introvert=introver
intrupsi=interupsi
inventarisir=inventarisasi
inzet=inset
ionosfir=ionosfer
iradah=iradat
irasionil=irasional
irodah=iradat
irrasional=irasional
islamiyah=Islamiah
isra’=israk
isteri=istri
istighfar=istigfar
istinja’=istinjak
istiqomah=istikamah
itali=Italia
itikad=iktikad
izajah=ijazah
jadah=juadah
jadual=jadwal
jaduwal=jadwal
jaelangkung=jalangkung
jagad=jagat
jahil=jail
jahiliyah=jahiliah
jailangkung=jalangkung
jaman=zaman
jarik=jarit
jeep=jip
jejer=jajar
jemaah=jamaah
jemaat=jamaah
jembel=gembel
jenasah=jenazah
jendral=jenderal
jenius=genius
jep=jip
jerembab=jerembap
jerembap=jerembab
jerigen=jeriken
jina=zina
jiujitsu=jujitsu
jizim=jisim
jogging=joging
joint=join
jomblo=jomlo
jor-joran=jorjoran
jubilum=jubileum
jum'at=Jumat
jumawa=jemawa
jungtur=junktur
jus=juz
justeru=justru
ka’bah=kakbah
kaabah=kakbah
kaburasi=karburasi
kaburator=karburator
kadaluarsa=kedaluwarsa
kadaluwarsa=kedaluwarsa
kaedah=kaidah
kaffah=kafah
kahyangan=kayangan
kakatua=kakaktua
kaleidioskop=kaleidoskop
kalkarim=kalkarium
kamboja=kemboja
kameraman=kamerawan
kameramen=kamerawan
kamuplase=kamuflase
kangguru=kanguru
kangker=kanker
kantung=kantong
kaos=kaus
karir=karier
karna=karena
kasep=kasip
kastil=kastel
katagori=kategori
kataketis=katekis
katalepsia=katalepsi
katalisa=katalisis
kate=katai
katholik=Katolik
katoda=katode
katring=katering
keburu=terburu
kecibeling=kejibeling
kecoak=kacoak
kedaluarsa=kedaluwarsa
kedele=kedelai
kekawin=kakawin
kelakatu=kelekatu
kelenger=kelengar
kelep=klep
kemana=ke mana
kempes=kempis
kenalpot=knalpot
kendor=kendur
kenop=knop
kerapan=karapan
kerawitan=karawitan
kerdip=kedip
kerdus=kardus
kerjasama=kerja sama
kerol=krol
kesturi=kasturi
kesumah=kesuma
ketapel=katapel
ketawa=tertawa
ketemu=bertemu
ketimun=mentimun
kharisma=karisma
kharismatik=karismatik
khaul=kaul
khayangan=kayangan
khutbah=khotbah
klar=kelar
klemak-klemek=kelemak-kelemek
klenger=kelengar
klengkeng=kelengkeng
klenik=kelenik
kleptomani=kleptomania
klop=kelop
klorofil=kloropil
kloter=keloter
kluwak=keluak
kluwih=keluih
knop=kenop
koboy=koboi
kocar-kacir=kucar-kacir
kolomnis=kolumnis
komersil=komersial
komfirmasi=konfirmasi
komoditi=komoditas
komplit=komplet
konggres=kongres
kongkow=kongko
kongkret=konkret
kongkrit=konkret
konkrit=konkret
konsekwen=konsekuen
konsleting=korsleting
kontinyu=kontinu
koor=kor
koordinir=koordinasi
kopor=koper
korden=gorden
korma=kurma
korp=korps
kosmonot=kosmonaut
kram=keram
kramat=keramat
kreatifitas=kreativitas
kreatip=kreatif
kreative=kreatif
kremi=keremi
kresek=keresek
kretek=keretek
krew=kru
kridit=kredit
krucil=kerucil
kulintang=kolintang
kumplit=komplet
kuno=kuna
kurnia=karunia
kusen=kosen
kusuma=kesuma
kutilang=ketilang
kwaci=kuaci
kwalitas=kualitas
kwalitet=kualitas
kwantitas=kuantitas
kwartal=kuartal
kwitangsi=kuitansi
kwitansi=kuitansi
kwota=kuota
kyai=kiai
la'nat=laknat
laba-laba=labah-labah
lajim=lazim
lamtorogung=lamtaragung
lapal=lafal
lasim=lazim
lasykar=laskar
laveransir=leveransir
ledeng=leding
legalisir=legalisasi
legenda=legende
lembab=lembap
leukimia=leukemia
levender=lavendel
liat=lihat
limfe=limfa
limpha=limpa
linier=linear
literal=litoral
liver=lever
lobang=lubang
loby=lobi
lohor=zhuhur
lokalisir=lokalisasi
longmarch=longmars
lontang-lantung=luntang-lantung
losin=lusin
lotere=lotre
luwak=luak
lux=luks
ma'af=maaf
ma’af=maaf
ma’fum=mafhum
ma’rifat=makrifat
ma’ruf=makruf
maag=mag
mabok=mabuk
madukoro=madukara
madzab=mazhab
maesa=mahesa
mafum=mafhum
maghrib=magrib
mahabarata=Mahabharata
mahapengasih=Maha Pengasih
mahardhika=mahardika
mahfudz=mahfuz
mahluk=makhluk
mahnet=magnet
maisena=maizena
makcomblang=mak comblang
makdum=makhdum
mala-praktek=malapraktik
malpraktek=malapraktik
malpraktik=malapraktik
mampet=mampat
manager=manajer
mandeg=mandek
manekin=maneken
mangkok=mangkuk
mantab=mantap
mantera=mantra
manuskrif=manuskrip
maqam=makam
maqom=makam
marathon=maraton
margarine=margarin
marjinal=marginal
mas=emas
masal=massal
mashur=masyhur
matematik=matematika
materai=meterai
mbalelo=mbalela
mebeler=mebel
melody=melodi
mencolok=menyolok
mendam=mandam
mendem=mandam
mentari=matahari
menterapkan=menerapkan
menterjemahkan=menerjemahkan
mentertawakan=menertawakan
menthol=mentol
menyan=kemenyan
menyuci=mencuci
meram=merem
merk=merek
merkurokrum=merkurokrom
mesjid=masjid
mess=mes
methanol=metanol
metoda=metode
metrei=meterai
mi’raj=mikraj
mie=mi
migren=migrain
mikroba=mikrobe
milyader=miliarder
milyar=miliar
milyoner=miliuner
milyuner=miliuner
miopi=miopia
missi=misi
mithos=mitos
miyop=miop
mobilisir=mobilisasi
moderen=modern
monarkhi=monarki
monopause=menopause
monotheis=monoteis
monotype=monotipe
montage=montase
moril=moral
moto=motto
mozaik=mosaik
mpu=empu
mu'jizat=mukjizat
mu’jizat=mukjizat
muadzin=muazin
muamalah=muamalat
mubaligh=mubalig
mubalighoh=mubaligat
mucikari=muncikari
mukjijat=mukjizat
mummi=mumi
muqaddimah=mukadimah
muqadimah=mukadimah
mursid=mursyid
mushala=musala
musholah=musala
musholla=musala
musium=museum
mustika=mestika
musyafir=musafir
nadar=nazar
nadzar=nazar
nafas=napas
nahas=naas
nahkoda=nakhoda
nakoda=nakhoda
nampak=tampak
narkotika=narkotik
nasehat=nasihat
negatip=negatif
negoisasi=negosiasi
negri=negeri
neko-neko=neka-neka
nenas=nanas
neo-kolonialisme=neokolonialisme
netralisir=netralisasi
netting=neting
netto=neto
ni'mat=nikmat
nipas=nifas
nomaden=nomad
nomer=nomor
non-aktif=nonaktif
nonsen=nonsens
nopember=November
notulen=notula
obrak-abrik=ubrak-abrik
obyek=objek
obyektif=objektif
oditorium=auditorium
okulele=ukulele
omset=omzet
ongseng=gongseng
oplet=opelet
opostrop=apostrof
orange=oranye
orangtua=orang tua
orchestra=orkestra
organisir=organisasi
orisinil=orisinal
orkhestra=orkestra
oseng-oseng=gongseng
osmosis=osmose
otentik=autentik
otobiografi=autobiografi
otodidak=autodidak
otopsi=autopsi
otto=oto
pacet=pacat
padepokan=pedepokan
padri=paderi
palem=palm
pamfelet=pamflet
panembahan=penembahan
pangkreas=pankreas
panili=vanili
panitra=panitera
panu=panau
paradox=paradoks
paragoge=parogog
paramedik=paramedis
parasit=parasut
pasca-panen=pascapanen
pasip=pasif
pasive=pasif
pasport=paspor
patent=paten
pateri=patri
patriakat=patriarkat
patrilinial=patrilineal
paviliyun=paviliun
pavilyun=paviliun
pebruari=Februari
pedes=pedas
pelaminan=pelamin
peliara=pelihara
penasehat=penasihat
pendopo=pendapa
pengrajin=perajin
perduli=peduli
pernis=vernis
petay=petai
pete=petai
philipina=Filipina
phobi=fobi
phobia=fobia
photo=foto
piara=pelihara
piranti=peranti
pirsawan=pemirsa
piyama=piama
plat=flat
plesetan=pelesetan
plesir=pelesir
plet=flat
pleton=peleton
plintir=pelintir
plonco=pelonco
plontos=pelontos
polio=folio
polpen=bolpoin
pondasi=fondasi
popular=populer
porcelain=porselen
porselain=porselen
praktek=praktik
profinsi=provinsi
project=proyek
projek=proyek
proklamir=proklamasi
propinsi=provinsi
pungkir=mungkir
putera=putra
qalam=kalam
qasidah=kasidah
qodariyah=kadariah
qodi=kadi
qodiriyah=Kadiriah
qolam=kalam
qolbu=kalbu
qomariyah=Kamariah
qomat=kamat
qona’ah=kanaah
qori=qari
qoriah=qariah
qosidah=kasidah
qunut=kunut
qur’an=Quran
quraisy=Kuraisy
rajia=razia
raka'at=rakaat
raka’at=rakaat
ramadhan=Ramadan
rangking=ranking
rangsel=ransel
ranzel=ransel
rapal=lafal
rapih=rapi
rapor=rapot
raport=rapor
rapot=rapor
rasia=razia
rasialist=rasialis
rasionil=rasional
real=riil
realisir=realisasi
reamur=Reaumur
rebo=Rabu
regim=rezim
rejeki=rezeki
rejeki=rizki
rejim=rezim
reka'at=rakaat
rekaat=rakaat
rekruit=rekrut
relif=relief
rembug=rembuk
renaisan=renaisans
renaisance=renaisans
rengking=ranking
reptil=reptilia
reservoir=reservoar
resiko=risiko
respon=respons
restauran=restoran
restaurant=restoran
resum=resume
reumatik=rematik
rezeki=rizki
rezki=rezeki
ridho=rida
riil=real
rilai=relai
rile=relai
riski=rizki
ritme=ritma
ritsluiting=ritsleting
rizki=rezeki
rizqi=rezeki
rizqi=rizki
robah=ubah
roboh=rubuh
rocker=roker
roh=ruh
rohaniawan=ruhaniwan
romadhon=Ramadan
romadlon=Ramadan
romo=rama
romusha=romusa
rong-rong=rongrong
ronsen=rontgen
route=rute
rubah=ubah
ruku’=rukuk
sa’i=sai
sahadat=syahadat
sahid=syahid
sahwat=syahwat
sakharin=sakarin
saklar=sakelar
salesma=selesma
samadi=semadi
sambel=sambal
sambrero=sombrero
sanawiyah=sanawiah
sangkalan=sengkalan
sangsi=sanksi
sanjak=sajak
sanksi=sangsi
sansekerta=Sanskerta
saos=saus
saparila=sarsaparila
saplemen=suplemen
sarap=saraf
sariawan=seriawan
sate=satai
satire=satir
score=skor
sebab-musabab=musabab
seign=sein
sejarahwan=sejarawan
sekedar=sekadar
sekering=sekring
sekertaris=sekretaris
sekolastik=skolastik
sekor=skor
sekores=skors
sekors=skors
seksama=saksama
seksuil=seksual
sekta=sekte
sekterian=sektarian
sekuadron=eskadron
sekuler=sekular
selinder=silinder
selulose=selulosa
semanda=semenda
sembrono=sembrana
semedi=semadi
sempoa=swipoa
sen=sein
sendal=sandal
senggama=sanggama
senikdok=sinekdoke
senopati=senapati
sense=sinse
sentausa=sentosa
sentimentil=sentimental
sentra=sentral
sepakbor=sepatbor
sepanduk=spanduk
sepesial=spesial
sepesies=spesies
sepionase=spionase
sepiritus=spiritus
sepirtus=spiritus
sepon=spons
sepre=seprai
seprei=seprai
sere=serai
sereh=serai
sertipikat=sertifikat
seruling=suling
seruni=serunai
service=servis
setansa=stanza
seterika=setrika
setriker=striker
sex=seks
seyogyanya=seyogianya
shaf=saf
shalat=salat
shampo=sampo
shampoo=sampo
she=syekh
shogun=syogun
sholat=salat
siapapun=siapa pun
sie=seksi
sign=sein
silahkan=silakan
silaturohmi=silaturahmi
silaturrahmi=silaturahmi
simple=simpel
sinagog=sinagoge
sindrome=sindrom
sinkope=sinkop
sinse=sengse
sintesa=sintesis
sintese=sintesis
sintesis=sintetis
siphilis=sifilis
sipilis=sifilis
sipoa=swipoa
sirik=syirik
sirine=sirene
sirop=sirup
sirup=sirop
sistim=sistem
sitar=ziter
siter=ziter
siwa=Syiwa
skholastik=skolastik
skop=sekop
skore=skor
skorsing=skors
sky=ski
slank=slang
slendro=selendro
sleng=slang
slenk=slang
slinder=silinder
smash=smes
sobat=sahabat
sodakoh=sedekah
sodaqoh=sedekah
sofball=sofbal
softball=sofbal
sokhib=sahib
sokoguru=sakaguru
solenoid=solenoide
sop=sup
sopmberero=sombrero
sorban=serban
sorga=surga
soup=sop
souvenir=suvenir
spagetti=spageti
spagheti=spageti
spakbor=sepatbor
spakbort=sepatbor
special=spesial
species=spesies
speedboat=spitbot
speedbot=spitbot
sping=sfing
spink=sfing
spinx=sfing
spirituil=spiritual
spon=spons
spor=sepur
sprai=seprai
sprint=sprin
spritus=spiritus
spur=sepur
sreg=srek
srigala=serigala
stagen=setagen
stand=stan
standard=standar
standarisasi=standardisasi
standart=standar
stansa=stanza
stater=starter
stereotipe=stereotip
sticker=stiker
stip=setip
stir=setir
stock=stok
stratejik=strategis
strawberi=stroberi
strawberry=stroberi
strawbery=stroberi
stress=stres
stricker=striker
strip=setrip
strok=stroke
subsidair=subsider
subtansi=substansi
subtitusi=substitusi
subyek=subjek
sudet=sodet
suhada=syuhada
suiter=sweter
sukur=syukur
sundel=sundal
sunnah=sunah
sup=sop
superman=supermen
supermasi=supremasi
supir=sopir
suplement=suplemen
sur=syur
surat=surah
survai=survei
survay=survei
surve=survei
survey=survei
susastera=susastra
sutra=sutera
syafa’at=syafaat
syah=sah
syahdu=sahdu
syahit=syahid
syaiton=setan
syaraf=saraf
syarap=saraf
syareat=syariat
syarekat=syarikat
syeikh=syekh
syetan=setan
syi’ar=siar
syiar=siar
syrup=sirup
system=sistem
syubat=syubhat
syubkhat=syubhat
syurga=surga
ta’ala=taala
ta’zim=takzim
tabligh=tablig
tagen=setagen
tahiyat=tahiat
tahta=takhta
takjim=takzim
talek=talk
tamzil=tamsil
tangker=tanker
tape=tapai
tapelak=taplak
tapi=tetapi
taqwa=takwa
tarhim=tarkhim
tarkim=tarkhim
taruna=teruna
tataniaga=tata niaga
tatto=tato
taubat=tobat
tauco=taoco
tauge=taoge
taulada=teladan
tauladan=teladan
tawakkal=tawakal
taxi=taksi
team=tim
tehnik=teknik
tehnologi=teknologi
tekat=tekad
teke=tokek
tekek=tokek
tekhnik=teknik
tekhnologi=teknologi
telefon=telepon
telephone=telepon
telfon=telepon
telor=telur
telpon=telepon
temenggung=tumenggung
temugiring=temu giring
tentram=tenteram
teoritis=teoretis
tepekong=toapekong
terimakasih=terima kasih
terlanjur=telanjur
terlantar=telantar
terlentang=telentang
terong=terung
terpedo=torpedo
terpercaya=tepercaya
terperdaya=teperdaya
tersina=terzina
teruwelu=terwelu
tes=test
test=tes
thawaf=tawaf
theater=teater
theologi=teologi
thesis=tesis
thoriqoh=tarikat
thoriqot=tarikat
ticket=tiket
timun=mentimun
tipes=tifus
tips=tip
toge=taoge
toladan=teladan
tolerir=toleransi
tonel=tonil
topaz=topas
toples=stoples
tour=tur
touris=turis
tournamen=turnamen
trachome=trakom
tradisionil=tradisional
trakhom=trakom
trampil=terampil
trapo=trafo
trenggiling=tenggiling
trengginas=terengginas
tribun=tribune
trilyun=triliun
trinale=trienale
tripang=teripang
triplek=tripleks
triplex=tripleks
tritis=teritis
trofosfir=trofosfer
tromol=teromol
trophi=trofi
tropi=trofi
trotoir=trotoar
trubus=terubus
truwelu=terwelu
tsanawiyah=sanawiah
tungro=tungra
turnament=turnamen
tut=tuts
type=tipe
ukhrowi=ukhrawi
uneg-uneg=unek-unek
urin=urine
ustad=ustaz
ustadz=ustaz
ustadzah=ustazah
vacum=vakum
valentin=valentine
vampire=vampir
vanilli=vanili
varices=varises
varitas=varietas
vaskuler=vaskular
vegetarian=vegetaris
vermaks=vermak
vignet=vinyet
villa=vila
weker=beker
yudikatif=judikatif
yudisial=judisial
yudo=judo
yunior=junior
yurisdiksi=jurisdiksi
yuyitsu=jujitsu
zahir=lahir
zam-zam=zamzam
zarafah=jerapah
zerafah=jerapah
zhuhur=zuhur
zig-zag=zigzag
zigote=zigot
zinah=zina
zohir=lahir
zone=zona
zygot=zigot

[gabungan]
akhirul kalam=akhirulkalam
al qur'an=Alquran
cap cai=capcai
drum band=drumben
foto copy=fotokopi
foto kopi=fotokopi
foto studio=studio foto
geladi resik=geladi bersih
inkar sunah=inkarsunah
kaca mata=kacamata
kakak tua=kakaktua
keji beling=kejibeling
kumpul kebo=kumpul kerbau
kung fu=kungfu
long march=longmars
mas kawin=maskawin
mass media=media massa
nina bobo=ninabobo
pas foto=pasfoto
pas photo=pasfoto
penghujan=hujan
radio aktif=radioaktif
saka guru=sakaguru
sedia kala=sediakala
serba aneka=serbaneka
serba neka=serbaneka
sosio drama=sosiodrama
suka cita=sukacita
tepa selira=tepaselira
tepo seliro=tepaselira
toa pekong=toapekong
ujian ulangan=ujian ulang